11111111111111111111111111111
10000000000000000000000000001
100C0EE0000000000000000000111
100P0000N00000000000000000001
11111111111111111111111111111