1111111111111
100N0000000E1
100P000000C01
1111111111111