11111111111111111111111
100000000100C0EE0111111
1111100000P000000000001
111111100000000N0000011
11111110001111111111111
11111111111111111111111