1111111111
10000P0001
100C0EE001
1111111111