11111111111111111111111
100000000100C0EE0111111
1000000000P000000000001
100000000000000N0000011
10000000000000000000001
11111111111111111111111