11111111111111111111111
100000000100C0EEP011111
11111000000000000000001
111111100000000N0000011
11111111111111111111111
11111111111111111111111