111111111
100000001
100P00001
100000001
10000EC01
111111111