1111111111111
100E000000001
100C000000001
100P000000001
1111111111111